111111
1P00C1
101111
111E11
111111
