1111111111111
100000C000001
1000111111001
1P0011E0C0001
1000111111001
100000C000001
1111111111111
