1111111111111
1C00C00C0C0C1
1C00011111001
1P0C011E00001
1111111111111
